R 1200 1000

SO textures/purplestone.xpm



NO textures/eagle.xpm


WE textures/wood.xpm

EA textures/bluestone.xpm

S textures/barril.xpm


F 53,104,45
C 0,170,228

        1111111111111111111111111
        1000000000110110201100001
        1011000001110000000000001
        1001000000000000N00200001
111111111011000001110000000000001
100000000011000001110111111111111
11110111111111011100000010001
11110111111111011101010010001
11000000110101011100000010001
10002000000000001100000010001
10000000000000001101010010001
1100000111010101111101111000111
11110111 1110101 101111010001
11111111 1111111 111111111111