R 1200 1000

SO textures/brick.xpm



NO textures/bookshelf.xpm


WE textures/wood.xpm

EA textures/bookshelfdark.xpm

S textures/barril.xpm


F 53,104,45
C 0,170,228

        111111111111011110111111100000000000000002000
        1000000000110110201100001                  22
        1011000001110000000000001
2       0000000000000000W00000000
111110111011000001110000000000001
100000000011000001  0000000011111
11110111111111011 00000000001
01110111111111011 01010000001
111111011111111011111111 11112