R 1200 1000

SO textures/brick.xpm



NO textures/bookshelf.xpm


WE textures/wood.xpm

EA textures/bookshelfdark.xpm

S textures/barril.xpm


F 53,104,45
C 0,170,228

        1111111111111111111111111
        1000000000110110201100001
        1011000001110000000000001
        1001000000000000N00200001
111111111011000001110000000000001
100000000011000001110000000011111
11110111111111011100000000001
11110111111111011101010000001
11111111111111111111111111111